XXXXEXXXXX
X        X
X   XXX  X
X   X    X
X   X    X
X X XXX  X
X X   X  X
X XX XX  E
X        X
XXXXXXXXXX
