XXXXXXXXXXXXXXXXXXXXXXXXXXXXXXXXXEXXXXXXXXXXXXXXXXXXXXXXXXXX
X        XX        XX        XX        XX        XX        X
X    XX  XX    XX  XX    XX  XX    XX  XX    XX  XX    XX  X
X      X XX      X XX                X XX      X XX      X X
X      X XX      X XX      X XX      X XX      X XX      X X
X X  XX  XX X  XX  XX X  XX  XX X  XX  XX X  XX  XX X  XX  X
X X             X  XX X   X  XX X   X  XX X   X  XX X   X  X
X XX XX  XX XX     XX XX XX  XX X  XX  XX XX XX  XX XX XX  X
X      X XX      X XX      X XX      X XX      X XX      X X
XX   XXXXXXXXX   XXXXXXXXXXXXXXXX  XXXXXXXXXXXXXXXXXXXXXXXXX
XX   XXXXXXXXX   XXXXXXXXXXXXXXXX  XXXXXXXXXXXXXXXXXXXXXXXXX
X        XX        XX        XX        XX        XX        X
X    XX  XX        XX    XX  XX    XX  XX    XX  XX    XX  X
X      X XX      X XX                          X XX      X X
X      X XX      X XX                          X XX      X X
X X  XX  XX X  XX  XX X  XX  XX X  XX  XX X  XX  XX X  XX  X
X X   X  XX X   X  XX X   X  XX X   X  XX X   X  XX X   X  X
X XX XX  XX XX XX  XX XX XX  XX XX XX  XX XX XX  XX XX XX  X
X                X XX      X XX      X XX      X XX      X X
XXXXXX     XXX   XXXXXXXXXXXXXXX  XXXXXXXXXXXXXXXXXXXXXXXXXX
XXXXXX     XXX   XXXXXXXXXXXXXXX  XXXXXXXXXXXXXXXXXXXXXXXXXX
X                  XX        XX        XX        XX        X
X    X         XX  XX    XX  XX    XX  XX    XX  XX    XX  X
X      X XX      X XX      X XX      X XX      X XX      X X
X      X XX      X XX      X XX      X XX      X XX      X X
X X  XX  XX X  XX  XX X  XX  XX X  XX  XX X  XX  XX X  XX  X
X X   X  XX X   X  XX X   X  XX X   X  XX X   X  XX X   X  X
X XX XX  XX XX XX   X XX XX                            XX  X
X      X XX                                              X X
XX  XXXX    X  X      XXXXX                           XXXXXX
XX  XXXX    X  X      XXXXX                           XXXXXX
X                                                          X
X    XX  XX    XX  XX    XX  XX    XX  XX    XX  XX    XX  X
X      X XX      X XX      X XX      X XX      X XX      X X
X      X XX      X XX      X XX      X XX      X XX      X X
X X  XX  XX X  XX  XX X  XX  XX X  XX  XX X  XX  XX X  XX  X
X X   X  XX X   X  XX X   X  XX X   X  XX X   X  XX X   X  X
X XX XX  XX XX XX  XX XX XX  XX XX XX  XX XX XX  XX XX XX  X
X      X XX      X XX      X XX      X XX      X XX      X X
XXXXXXXXXXXXXXXXXXXXXXXXXXXXXXXXXXXXXXXXXXXXXXXXXXXXXXXXXXXX