XXXXEXXXXX
X        X
X   XXX  X
X   X    X
X   X    X
X X XXX  X
X X   X  X
X X  XX  E
X        X
XXXXXXXXXX
