XXXXEXXXXX
X        X
X    XX  X
X      X X
X      X X
X X  XX  X
X X   X  X
X XX XX  E
X      X X
XXXXEXXXXX