XXXXXXXXXX
X        X
E    XX  X
X      X X
X      X X
X X  XX  X
X X      E
X XX XX  X
X      X X
XXXXXXXXXX